Fecha,Incoming Calls,Answered Calls,Answer Rate,Abandoned Calls,Answer Speed (AVG),Talk Duration (AVG),Waiting Time (AVG),Service Level (20 Seconds)
2020-01-01,217,204,0.94,13,17,134,165,0.76
2020-01-02,200,182,0.91,18,20,142,415,0.73
2020-01-03,216,198,0.92,18,18,158,230,0.74
2020-01-04,155,145,0.94,10,15,149,192,0.80
2020-01-05,37,37,1.00,0,3,126,35,0.97
2020-01-06,315,304,0.97,11,18,95,157,0.77
2020-01-07,252,244,0.97,8,13,110,122,0.82
2020-01-08,213,205,0.96,8,10,130,202,0.88
2020-01-09,219,200,0.91,19,15,138,372,0.79
2020-01-10,371,348,0.94,23,19,100,209,0.74
2020-01-11,166,164,0.99,2,12,130,166,0.81
2020-01-12,32,32,1.00,0,2,123,3,1.00
2020-01-13,231,222,0.96,9,8,109,138,0.86
2020-01-14,205,197,0.96,8,7,112,168,0.93
2020-01-15,338,313,0.93,25,13,111,220,0.80
2020-01-16,180,174,0.97,6,13,138,206,0.84
2020-01-17,226,211,0.93,15,20,124,293,0.76
2020-01-18,226,212,0.94,14,10,123,165,0.84
2020-01-19,45,44,0.98,1,2,124,55,0.98
2020-01-20,218,194,0.89,24,26,163,388,0.69
2020-01-21,187,174,0.93,13,15,136,279,0.82
2020-01-22,191,184,0.96,7,10,129,220,0.86
2020-01-23,188,174,0.93,14,15,145,189,0.77
2020-01-24,154,148,0.96,6,10,147,216,0.85
2020-01-25,166,150,0.90,16,18,146,278,0.77
2020-01-26,58,57,0.98,1,4,146,58,0.95
2020-01-27,160,153,0.96,7,10,143,165,0.85
2020-01-28,86,79,0.92,7,32,163,280,0.62
2020-01-29,180,170,0.94,10,23,151,345,0.78
2020-01-30,210,192,0.91,18,26,136,335,0.67
2020-01-31,163,157,0.96,6,14,139,175,0.81
2020-02-01,143,140,0.98,3,15,140,283,0.83
2020-02-02,57,55,0.96,2,6,123,110,0.91
2020-02-03,179,172,0.96,7,13,137,203,0.82
2020-02-04,194,184,0.95,10,24,144,199,0.70
2020-02-05,201,196,0.98,5,15,136,293,0.82
2020-02-06,218,189,0.87,29,32,157,484,0.57
2020-02-07,194,190,0.98,4,16,142,122,0.82
2020-02-08,227,219,0.96,8,15,164,235,0.84
2020-02-09,52,52,1.00,0,9,136,52,0.94
2020-02-10,385,370,0.96,15,20,131,190,0.76
2020-02-11,137,130,0.95,7,16,146,587,0.76
2020-02-12,254,252,0.99,2,10,128,70,0.91
2020-02-13,211,206,0.98,5,11,144,277,0.87
2020-02-14,282,279,0.99,3,7,138,71,0.93
2020-02-15,262,260,0.99,2,8,151,73,0.91
2020-02-16,65,63,0.97,2,12,142,130,0.86
2020-02-17,325,323,0.99,2,5,133,74,0.97
2020-02-18,235,230,0.98,5,5,139,58,0.96
2020-02-19,215,212,0.99,3,5,134,58,0.96
2020-02-20,85,85,1.00,0,3,146,55,0.98
2020-02-21,195,195,1.00,0,5,144,133,0.97
2020-02-22,188,182,0.97,6,15,134,111,0.84
2020-02-23,58,58,1.00,0,6,142,52,0.95
2020-02-24,251,247,0.98,4,14,136,113,0.84
2020-02-25,181,178,0.98,3,12,144,117,0.86
2020-02-26,228,213,0.93,15,26,136,187,0.64
2020-02-27,165,163,0.99,2,9,145,140,0.90
2020-02-28,185,179,0.97,6,17,137,153,0.79
2020-02-29,172,164,0.95,8,18,147,249,0.77
2020-03-01,57,51,0.89,6,7,107,220,0.91
2020-03-02,200,192,0.96,8,10,138,169,0.86
2020-03-03,202,199,0.99,3,8,125,77,0.91
2020-03-04,217,212,0.98,5,7,115,110,0.94
2020-03-05,225,223,0.99,2,9,129,66,0.92
2020-03-06,235,231,0.98,4,8,139,66,0.96
2020-03-07,202,201,1.00,1,8,141,113,0.95
2020-03-08,43,39,0.91,4,11,135,110,0.76
2020-03-09,194,187,0.96,7,10,147,150,0.87
2020-03-10,202,199,0.99,3,13,143,118,0.86
2020-03-11,146,140,0.96,6,12,133,275,0.83
2020-03-12,147,145,0.99,2,9,135,58,0.91
2020-03-13,155,145,0.94,10,12,153,273,0.82
2020-03-14,157,156,0.99,1,9,144,53,0.93
2020-03-15,38,36,0.95,2,13,131,59,0.84
2020-03-16,166,162,0.98,4,9,149,165,0.89
2020-03-17,226,216,0.96,10,13,135,106,0.81
2020-03-18,253,247,0.98,6,10,114,77,0.88
2020-03-19,134,134,1.00,0,3,133,26,1.00
2020-03-20,70,67,0.96,3,12,121,76,0.84
2020-03-21,83,82,0.99,1,7,123,76,0.95
2020-03-22,42,40,0.95,2,8,111,96,0.90
2020-03-23,66,64,0.97,2,5,120,99,0.95
2020-03-24,153,146,0.95,7,20,128,272,0.76
2020-03-25,141,135,0.96,6,23,126,135,0.67
2020-03-26,146,143,0.98,3,17,117,147,0.78
2020-03-27,144,140,0.97,4,12,113,125,0.84
2020-03-28,105,103,0.98,2,17,115,121,0.76
2020-03-29,36,35,0.97,1,16,114,91,0.77
2020-03-30,61,57,0.93,4,4,120,221,0.92
2020-03-31,60,58,0.97,2,11,128,94,0.85
2020-04-01,18,17,0.94,1,5,159,20,1.00
2020-04-02,206,202,0.98,4,9,114,70,0.89
2020-04-03,194,193,0.99,1,11,117,94,0.85
2020-04-04,206,200,0.97,6,10,128,120,0.86
2020-04-05,53,53,1.00,0,18,128,130,0.77
2020-04-06,147,145,0.99,2,9,110,84,0.88
2020-04-07,201,197,0.98,4,9,119,143,0.91
2020-04-08,202,198,0.98,4,10,129,71,0.89
2020-04-09,226,219,0.97,7,10,132,165,0.88
2020-04-10,167,163,0.98,4,7,129,110,0.93
2020-04-11,164,164,1.00,0,11,137,105,0.89
2020-04-12,42,41,0.98,1,11,129,78,0.88
2020-04-13,79,78,0.99,1,7,143,48,0.95
2020-04-14,165,162,0.98,3,9,129,110,0.90
2020-04-15,180,174,0.97,6,16,136,103,0.78
2020-04-16,179,176,0.98,3,10,146,110,0.88
2020-04-17,217,215,0.99,2,8,128,127,0.92
2020-04-18,171,167,0.98,4,10,135,110,0.86
2020-04-19,37,37,1.00,0,9,117,82,0.86
2020-04-20,215,206,0.96,9,18,129,165,0.81
2020-04-21,218,212,0.97,6,16,137,129,0.84
2020-04-22,205,202,0.99,3,11,145,97,0.91
2020-04-23,195,190,0.97,5,12,142,74,0.89
2020-04-24,181,176,0.97,5,13,133,76,0.82
2020-04-25,212,206,0.97,6,11,140,109,0.89
2020-04-26,33,32,0.97,1,8,148,55,0.91
2020-04-27,298,287,0.96,11,13,95,171,0.83
2020-04-28,158,156,0.99,2,11,143,92,0.90
2020-04-29,156,154,0.99,2,12,133,61,0.86
2020-04-30,163,163,1.00,0,10,122,166,0.93
2020-05-01,98,98,1.00,0,7,130,70,0.94
2020-05-02,255,249,0.98,6,15,139,331,0.83
2020-05-03,50,49,0.98,1,8,122,57,0.92
2020-05-04,290,289,1.00,1,12,121,70,0.89
2020-05-05,296,281,0.95,15,22,128,270,0.74
2020-05-06,260,257,0.99,3,17,133,80,0.87
2020-05-07,201,193,0.96,8,19,143,122,0.77
2020-05-08,132,131,0.99,1,17,133,90,0.77
2020-05-09,167,165,0.99,2,9,126,57,0.92
2020-05-10,85,79,0.93,6,18,145,113,0.77
2020-05-11,244,236,0.97,8,21,149,116,0.76
2020-05-12,186,182,0.98,4,14,133,98,0.79
2020-05-13,278,264,0.95,14,19,140,130,0.77
2020-05-14,272,268,0.99,4,15,150,105,0.80
2020-05-15,218,206,0.95,12,25,141,221,0.67
2020-05-16,152,148,0.97,4,14,138,85,0.83
2020-05-17,48,43,0.90,5,22,121,81,0.70
2020-05-18,186,181,0.97,5,14,140,109,0.85
2020-05-19,182,180,0.99,2,8,130,58,0.93
2020-05-20,192,188,0.98,4,20,118,116,0.76
2020-05-21,155,148,0.95,7,14,144,138,0.85
2020-05-22,144,142,0.99,2,11,139,65,0.90
2020-05-23,164,162,0.99,2,12,155,110,0.85
2020-05-24,27,26,0.96,1,11,124,77,0.81
2020-05-25,177,175,0.99,2,11,139,95,0.91
2020-05-26,134,131,0.98,3,14,143,99,0.81
2020-05-27,125,120,0.96,5,14,140,172,0.85
2020-05-28,167,163,0.98,4,16,144,72,0.81
2020-05-29,169,167,0.99,2,9,134,104,0.90
2020-05-30,162,160,0.99,2,16,135,91,0.83
2020-05-31,25,25,1.00,0,16,155,58,0.76
2020-06-01,157,146,0.93,11,17,137,111,0.80
2020-06-02,166,154,0.93,12,25,138,219,0.66
2020-06-03,58,55,0.95,3,16,131,165,0.74
2020-06-04,75,74,0.99,1,15,133,198,0.84
2020-06-05,28,28,1.00,0,7,148,51,0.96
2020-06-06,108,107,0.99,1,9,131,59,0.94
2020-06-07,21,21,1.00,0,7,178,58,0.95
2020-06-08,189,182,0.96,7,21,130,286,0.76
2020-06-09,161,155,0.96,6,19,147,110,0.72
2020-06-10,155,151,0.97,4,17,140,109,0.81
2020-06-11,161,150,0.93,11,17,142,165,0.75
2020-06-12,132,129,0.98,3,27,142,154,0.65
2020-06-13,122,119,0.98,3,16,144,110,0.80
2020-06-14,17,17,1.00,0,21,160,58,0.76
2020-06-15,45,45,1.00,0,6,126,57,0.96
2020-06-16,177,172,0.97,5,20,143,171,0.76
2020-06-17,133,132,0.99,1,10,145,59,0.93
2020-06-18,177,167,0.94,10,15,142,275,0.83
2020-06-19,127,124,0.98,3,16,142,105,0.82
2020-06-20,148,147,0.99,1,16,131,191,0.83
2020-06-21,23,23,1.00,0,32,122,163,0.65
2020-06-22,141,134,0.95,7,24,158,149,0.72
2020-06-23,124,120,0.97,4,20,153,178,0.82
2020-06-24,165,156,0.95,9,25,141,158,0.71
2020-06-25,168,166,0.99,2,21,153,223,0.80
2020-06-26,198,188,0.95,10,22,152,165,0.71
2020-06-27,139,133,0.96,6,17,160,183,0.80
2020-06-28,46,45,0.98,1,10,134,76,0.89
2020-06-29,184,174,0.95,10,23,157,275,0.77
2020-06-30,207,190,0.92,17,21,143,246,0.71
2020-07-01,191,180,0.94,11,21,152,113,0.77
2020-07-02,213,204,0.96,9,24,146,166,0.70
2020-07-03,483,451,0.93,32,16,57,525,0.79
2020-07-04,547,526,0.96,21,19,81,234,0.82
2020-07-05,54,53,0.98,1,25,156,78,0.70
2020-07-06,275,261,0.95,14,22,133,132,0.74
2020-07-07,205,195,0.95,10,24,154,180,0.71
2020-07-08,80,77,0.96,3,10,131,93,0.90
2020-07-09,200,195,0.98,5,21,150,168,0.75
2020-07-10,154,150,0.97,4,21,149,165,0.74
2020-07-11,163,155,0.95,8,23,138,146,0.75
2020-07-12,12,12,1.00,0,25,217,88,0.67
2020-07-13,218,212,0.97,6,20,116,251,0.76
2020-07-14,172,163,0.95,9,18,129,113,0.82
2020-07-15,205,194,0.95,11,18,144,101,0.81
2020-07-16,178,168,0.94,10,23,148,170,0.69
2020-07-17,214,201,0.94,13,23,131,144,0.66
2020-07-18,169,161,0.95,8,23,137,275,0.72
2020-07-19,46,46,1.00,0,25,144,95,0.72
2020-07-20,183,177,0.97,6,18,150,67,0.81
2020-07-21,208,190,0.91,18,21,145,110,0.74
2020-07-22,234,224,0.96,10,22,135,200,0.74
2020-07-23,204,194,0.95,10,18,137,110,0.79
2020-07-24,204,189,0.93,15,21,135,236,0.71
2020-07-25,99,99,1.00,0,16,145,62,0.83
2020-07-26,29,27,0.93,2,19,167,142,0.79
2020-07-27,167,159,0.95,8,23,148,275,0.70
2020-07-28,164,161,0.98,3,17,155,97,0.82
2020-07-29,158,147,0.93,11,21,154,123,0.72
2020-07-30,165,161,0.98,4,17,146,66,0.78
2020-07-31,129,124,0.96,5,23,148,110,0.71
2020-08-01,155,149,0.96,6,23,146,259,0.75
2020-08-02,24,22,0.92,2,28,144,81,0.54
2020-08-03,209,200,0.96,9,23,144,131,0.67
2020-08-04,239,226,0.95,13,26,139,170,0.67
2020-08-05,229,210,0.92,19,29,143,496,0.64
2020-08-06,194,172,0.89,22,23,140,376,0.66
2020-08-07,202,179,0.89,23,24,136,170,0.64
2020-08-08,268,254,0.95,14,15,111,160,0.81
2020-08-09,52,49,0.94,3,18,138,137,0.76
2020-08-10,414,397,0.96,17,23,118,332,0.71
2020-08-11,346,325,0.94,21,27,142,165,0.66
2020-08-12,187,179,0.96,8,25,134,179,0.67
2020-08-13,203,186,0.92,17,24,158,275,0.70
2020-08-14,204,194,0.95,10,18,153,122,0.82
2020-08-15,126,121,0.96,5,21,152,111,0.71
2020-08-16,36,36,1.00,0,17,127,91,0.78
2020-08-17,180,165,0.92,15,27,150,139,0.66
2020-08-18,169,162,0.96,7,20,145,113,0.75
2020-08-19,155,151,0.97,4,21,140,165,0.71
2020-08-20,169,137,0.81,32,38,144,330,0.40
2020-08-21,61,45,0.74,16,32,169,330,0.41
2020-08-22,167,136,0.81,31,42,156,328,0.36
2020-08-23,32,27,0.84,5,35,142,190,0.53
2020-08-24,229,148,0.65,81,36,168,639,0.43
2020-08-25,208,204,0.98,4,19,186,314,0.78
2020-08-26,175,168,0.96,7,25,171,224,0.65
2020-08-27,177,167,0.94,10,22,161,264,0.68
2020-08-28,822,767,0.93,55,24,85,275,0.64
2020-08-29,87,85,0.98,2,23,145,137,0.68
2020-08-30,41,39,0.95,2,15,162,78,0.83
2020-08-31,280,257,0.92,23,31,153,475,0.64
2020-09-01,199,192,0.96,7,22,166,168,0.74
2020-09-02,252,239,0.95,13,29,149,216,0.65
2020-09-03,220,208,0.95,12,20,156,165,0.76
2020-09-04,206,193,0.94,13,24,147,217,0.75
2020-09-05,217,206,0.95,11,22,146,122,0.71
2020-09-06,24,24,1.00,0,19,170,67,0.79
2020-09-07,248,238,0.96,10,13,147,110,0.85
2020-09-08,222,212,0.96,10,20,145,221,0.78
2020-09-09,190,178,0.94,12,32,147,165,0.55
2020-09-10,238,231,0.97,7,20,147,123,0.80
2020-09-11,214,205,0.96,9,20,154,154,0.79
2020-09-12,186,176,0.95,10,23,135,303,0.71
2020-09-13,21,20,0.95,1,14,145,54,0.85
2020-09-14,169,157,0.93,12,21,149,270,0.78
2020-09-15,149,141,0.95,8,16,158,157,0.79
2020-09-16,171,164,0.96,7,19,142,229,0.77
2020-09-17,127,122,0.96,5,13,142,85,0.88
2020-09-18,21,21,1.00,0,8,183,58,0.90
2020-09-19,5,5,1.00,0,14,157,59,0.80
2020-09-20,33,32,0.97,1,26,124,105,0.67
2020-09-21,145,139,0.96,6,20,148,221,0.79
2020-09-22,129,127,0.98,2,19,133,109,0.76
2020-09-23,194,178,0.92,16,26,156,320,0.67
2020-09-24,194,187,0.96,7,24,145,224,0.77
2020-09-25,202,195,0.97,7,21,141,179,0.75
2020-09-26,214,208,0.97,6,13,139,57,0.88
2020-09-27,28,28,1.00,0,13,133,78,0.89
2020-09-28,191,187,0.98,4,15,143,100,0.83
2020-09-29,205,197,0.96,8,21,147,143,0.74
2020-09-30,198,196,0.99,2,23,148,123,0.74
2020-10-01,184,177,0.96,7,20,161,110,0.79
2020-10-02,184,174,0.95,10,25,147,167,0.70
2020-10-03,168,160,0.95,8,26,145,124,0.68
2020-10-04,39,37,0.95,2,14,128,63,0.81
2020-10-05,225,210,0.93,15,28,133,153,0.67
2020-10-06,182,174,0.96,8,32,136,236,0.60
2020-10-07,346,305,0.88,41,45,117,307,0.45
2020-10-08,450,441,0.98,9,19,113,151,0.78
2020-10-09,259,248,0.96,11,20,126,111,0.75
2020-10-10,231,214,0.93,17,18,126,151,0.80
2020-10-11,48,47,0.98,1,13,123,106,0.90
2020-10-12,246,236,0.96,10,20,131,276,0.79
2020-10-13,202,195,0.97,7,25,135,333,0.75
2020-10-14,153,150,0.98,3,15,135,132,0.82
2020-10-15,178,172,0.97,6,19,135,275,0.78
2020-10-16,172,165,0.96,7,19,144,204,0.79
2020-10-17,208,200,0.96,8,26,143,195,0.69
2020-10-18,77,76,0.99,1,29,136,114,0.58
2020-10-19,291,250,0.86,41,41,140,430,0.55
2020-10-20,219,212,0.97,7,21,139,110,0.77
2020-10-21,173,169,0.98,4,18,133,134,0.81
2020-10-22,204,197,0.97,7,17,143,117,0.80
2020-10-23,216,185,0.86,31,30,137,386,0.61
2020-10-24,461,441,0.96,20,30,138,220,0.61
2020-10-25,56,55,0.98,1,26,131,113,0.66
2020-10-26,192,176,0.92,16,23,125,167,0.68
2020-10-27,382,365,0.96,17,20,95,173,0.73
2020-10-28,246,223,0.91,23,25,134,324,0.72
2020-10-29,48,46,0.96,2,26,134,85,0.72
2020-10-30,221,205,0.93,16,26,135,195,0.63
2020-10-31,275,261,0.95,14,33,139,178,0.59
2020-11-01,39,36,0.92,3,19,113,112,0.78
2020-11-02,250,236,0.94,14,29,128,247,0.59
2020-11-03,197,184,0.93,13,29,143,221,0.56
2020-11-04,223,208,0.93,15,28,141,411,0.72
2020-11-05,240,236,0.98,4,18,134,128,0.78
2020-11-06,55,52,0.95,3,16,139,102,0.78
2020-11-07,59,54,0.92,5,8,126,121,0.85
2020-11-08,36,31,0.86,5,11,142,116,0.72
2020-11-09,229,219,0.96,10,13,127,155,0.85
2020-11-10,206,189,0.92,17,15,139,228,0.83
2020-11-11,225,200,0.89,25,21,141,282,0.73
2020-11-12,200,193,0.97,7,17,143,220,0.79
2020-11-13,189,179,0.95,10,22,130,401,0.78
2020-11-14,169,159,0.94,10,22,143,206,0.74
2020-11-15,41,40,0.98,1,25,152,125,0.68
2020-11-16,218,187,0.86,31,48,135,313,0.52
2020-11-17,194,185,0.95,9,21,130,165,0.72
2020-11-18,176,172,0.98,4,16,140,135,0.82
2020-11-19,181,179,0.99,2,18,141,137,0.81
2020-11-20,159,151,0.95,8,29,119,221,0.61
2020-11-21,144,135,0.94,9,24,132,385,0.71
2020-11-22,30,29,0.97,1,33,178,136,0.60
2020-11-23,197,185,0.94,12,24,138,140,0.68
2020-11-24,56,47,0.84,9,24,142,168,0.59
2020-11-25,182,153,0.84,29,38,137,641,0.54
2020-11-26,178,166,0.93,12,30,144,312,0.62
2020-11-27,183,164,0.90,19,25,124,220,0.66
2020-11-28,197,182,0.92,15,28,145,260,0.65
2020-11-29,60,58,0.97,2,37,156,190,0.54
2020-11-30,241,224,0.93,17,23,145,165,0.70
2020-12-01,307,295,0.96,12,29,136,165,0.60
2020-12-02,295,289,0.98,6,26,143,191,0.71
2020-12-03,239,230,0.96,9,26,134,194,0.69
2020-12-04,241,231,0.96,10,23,145,112,0.72
2020-12-05,211,195,0.92,16,33,162,196,0.52
2020-12-06,40,35,0.88,5,40,155,192,0.48
2020-12-07,192,174,0.91,18,32,136,220,0.56
2020-12-08,201,179,0.89,22,35,138,220,0.57
2020-12-09,274,247,0.90,27,28,130,244,0.64
2020-12-10,205,176,0.86,29,41,136,311,0.46
2020-12-11,177,160,0.90,17,28,140,239,0.59
2020-12-12,159,151,0.95,8,22,128,442,0.73
2020-12-13,33,28,0.85,5,13,150,62,0.67
2020-12-14,228,210,0.92,18,23,128,189,0.67
2020-12-15,177,172,0.97,5,25,135,172,0.69
2020-12-16,197,169,0.86,28,34,150,461,0.56
2020-12-17,721,616,0.85,105,57,115,348,0.28
2020-12-18,301,270,0.90,31,42,125,606,0.42
2020-12-19,179,175,0.98,4,24,141,192,0.71
2020-12-20,45,45,1.00,0,16,131,201,0.87
2020-12-21,180,164,0.91,16,25,142,110,0.62
2020-12-22,206,200,0.97,6,22,139,127,0.75
2020-12-23,187,181,0.97,6,32,150,234,0.63
2020-12-24,186,177,0.95,9,28,142,330,0.68
2020-12-25,189,180,0.95,9,35,135,204,0.56
2020-12-26,127,116,0.91,11,34,145,166,0.56
2020-12-27,93,90,0.97,3,26,117,177,0.63
2020-12-28,328,292,0.89,36,37,137,385,0.50
2020-12-29,238,223,0.94,15,33,143,220,0.59
2020-12-30,237,222,0.94,15,34,144,172,0.54
2020-12-31,257,235,0.91,22,45,151,264,0.45
2021-01-01,238,223,0.94,15,32,137,202,0.55
2021-01-02,199,164,0.82,35,32,133,416,0.59
2021-01-03,30,27,0.90,3,32,154,157,0.61
2021-01-04,176,163,0.93,13,38,125,330,0.54
2021-01-05,162,144,0.89,18,41,145,220,0.50
2021-01-06,169,157,0.93,12,29,149,116,0.54
2021-01-07,155,146,0.94,9,30,138,190,0.51
2021-01-08,247,205,0.83,42,49,146,456,0.38
2021-01-09,191,186,0.97,5,24,134,114,0.71
2021-01-10,30,29,0.97,1,6,135,46,0.93
2021-01-11,316,290,0.92,26,31,141,242,0.59
2021-01-12,211,195,0.92,16,34,141,385,0.56
2021-01-13,208,169,0.81,39,45,138,435,0.46
2021-01-14,130,124,0.95,6,22,137,135,0.69
2021-01-15,134,129,0.96,5,24,132,208,0.71
2021-01-16,124,121,0.98,3,27,139,199,0.71
2021-01-17,47,43,0.91,4,37,138,196,0.54
2021-01-18,197,186,0.94,11,28,138,147,0.64
2021-01-19,158,146,0.92,12,31,144,220,0.57
2021-01-20,163,151,0.93,12,28,133,293,0.64
2021-01-21,178,160,0.90,18,35,159,281,0.54
2021-01-22,151,128,0.85,23,35,143,338,0.53
2021-01-23,118,106,0.90,12,33,145,272,0.55
2021-01-24,31,28,0.90,3,40,160,192,0.43
2021-01-25,139,134,0.96,5,31,143,170,0.59
2021-01-26,171,154,0.90,17,27,144,388,0.66
2021-01-27,160,156,0.98,4,27,135,107,0.65
2021-01-28,177,169,0.95,8,29,151,220,0.64
2021-01-29,187,180,0.96,7,26,142,356,0.66
2021-01-30,147,138,0.94,9,26,144,319,0.61
2021-01-31,35,35,1.00,0,8,130,47,0.89
2021-02-01,208,194,0.93,14,35,146,266,0.57
2021-02-02,162,155,0.96,7,19,137,223,0.78
2021-02-03,152,143,0.94,9,22,148,221,0.70
2021-02-04,132,125,0.95,7,26,127,232,0.69
2021-02-05,133,131,0.99,2,12,139,79,0.87
2021-02-06,129,121,0.94,8,33,157,241,0.61
2021-02-07,37,35,0.95,2,19,141,92,0.76
2021-02-08,56,54,0.96,2,13,153,133,0.87
2021-02-09,215,210,0.98,5,12,94,102,0.88
2021-02-10,50,46,0.92,4,14,162,73,0.72
2021-02-11,136,129,0.95,7,22,146,150,0.66
2021-02-12,160,142,0.89,18,35,154,190,0.56
2021-02-13,132,115,0.87,17,36,147,275,0.49
2021-02-14,30,28,0.93,2,47,156,142,0.40
2021-02-15,150,140,0.93,10,29,152,131,0.63
2021-02-16,160,144,0.90,16,46,159,265,0.50
2021-02-17,132,122,0.92,10,37,158,231,0.50
2021-02-18,161,151,0.94,10,28,127,170,0.61
2021-02-19,156,149,0.96,7,22,148,251,0.70
2021-02-20,137,128,0.93,9,31,150,304,0.63
2021-02-21,28,25,0.89,3,60,167,286,0.32
2021-02-22,141,133,0.94,8,33,162,278,0.63
2021-02-23,130,123,0.95,7,32,160,140,0.53
2021-02-24,161,155,0.96,6,27,163,163,0.74
2021-02-25,139,132,0.95,7,28,160,111,0.63
2021-02-26,167,130,0.78,37,29,154,716,0.55
2021-02-27,138,122,0.88,16,35,169,330,0.58
2021-02-28,47,44,0.94,3,26,191,209,0.63
2021-03-01,230,206,0.90,24,38,154,275,0.47
2021-03-02,177,153,0.86,24,30,173,268,0.55
2021-03-03,159,149,0.94,10,33,160,272,0.61
2021-03-04,151,135,0.89,16,36,152,281,0.53
2021-03-05,138,126,0.91,12,34,137,250,0.60
2021-03-06,118,118,1.00,0,26,153,98,0.66
2021-03-07,22,21,0.95,1,42,144,176,0.52
2021-03-08,177,156,0.88,21,42,159,196,0.42
2021-03-09,156,147,0.94,9,29,151,221,0.64
2021-03-10,123,121,0.98,2,26,148,209,0.64
2021-03-11,130,125,0.96,5,26,149,208,0.67
2021-03-12,141,134,0.95,7,39,153,188,0.56
2021-03-13,121,113,0.93,8,38,158,258,0.51
2021-03-14,35,31,0.89,4,34,125,269,0.47
2021-03-15,240,226,0.94,14,36,135,246,0.57
2021-03-16,130,118,0.91,12,32,143,220,0.58
2021-03-17,140,130,0.93,10,29,151,455,0.62
2021-03-18,131,111,0.85,20,38,196,599,0.60
2021-03-19,74,74,1.00,0,13,175,113,0.89
2021-03-20,24,24,1.00,0,12,167,57,0.83
2021-03-21,11,10,0.91,1,13,144,55,0.82
2021-03-22,28,26,0.93,2,10,150,86,0.81
2021-03-23,43,43,1.00,0,8,143,52,0.88
2021-03-24,62,62,1.00,0,17,132,86,0.82
2021-03-25,70,69,0.99,1,22,126,520,0.81
2021-03-26,107,97,0.91,10,21,146,160,0.69
2021-03-27,91,85,0.93,6,30,147,349,0.63
2021-03-28,25,25,1.00,0,11,160,55,0.84
2021-03-29,85,79,0.93,6,24,151,187,0.72
2021-03-30,91,83,0.91,8,26,157,220,0.63
2021-03-31,48,46,0.96,2,11,133,82,0.83
2021-04-01,14,11,0.79,3,18,147,165,0.62
2021-04-02,43,42,0.98,1,22,167,195,0.74
2021-04-03,74,69,0.93,5,23,151,288,0.77
2021-04-04,33,33,1.00,0,14,145,89,0.82
2021-04-05,124,112,0.90,12,26,156,330,0.65
2021-04-06,130,126,0.97,4,25,150,178,0.66
2021-04-07,139,139,1.00,0,18,160,183,0.78
2021-04-08,138,130,0.94,8,26,147,112,0.61
2021-04-09,125,119,0.95,6,22,149,220,0.68
2021-04-10,98,96,0.98,2,20,156,173,0.77
2021-04-11,12,12,1.00,0,18,187,96,0.83
2021-04-12,119,117,0.98,2,18,159,163,0.78
2021-04-13,100,96,0.96,4,21,157,165,0.76
2021-04-14,146,133,0.91,13,31,150,220,0.58
2021-04-15,131,127,0.97,4,22,145,148,0.73
2021-04-16,107,104,0.97,3,8,147,96,0.92
2021-04-17,112,105,0.94,7,24,158,268,0.67
2021-04-18,21,21,1.00,0,32,151,85,0.52
2021-04-19,125,104,0.83,21,37,164,165,0.45
2021-04-20,35,34,0.97,1,24,132,136,0.74
2021-04-21,121,109,0.90,12,38,152,321,0.54
2021-04-22,135,122,0.90,13,32,154,188,0.58
2021-04-23,117,114,0.97,3,22,158,147,0.76
2021-04-24,114,97,0.85,17,39,170,496,0.45
2021-04-25,50,49,0.98,1,35,175,142,0.52
2021-04-26,207,198,0.96,9,16,163,231,0.80
2021-04-27,189,183,0.97,6,21,151,238,0.74
2021-04-28,162,156,0.96,6,24,142,128,0.66
2021-04-29,177,165,0.93,12,26,151,230,0.66
2021-04-30,177,167,0.94,10,23,155,165,0.69
2021-05-01,163,134,0.82,29,38,162,436,0.47
2021-05-02,24,20,0.83,4,26,203,136,0.65
2021-05-03,146,139,0.95,7,18,154,381,0.76
2021-05-04,143,141,0.99,2,22,165,165,0.72
2021-05-05,132,122,0.92,10,31,148,276,0.56
2021-05-06,137,130,0.95,7,26,145,126,0.64
2021-05-07,112,104,0.93,8,43,157,247,0.41
2021-05-08,110,91,0.83,19,50,158,312,0.37
2021-05-09,24,22,0.92,2,32,134,286,0.58
2021-05-10,168,154,0.92,14,36,164,232,0.49
2021-05-11,146,116,0.79,30,42,148,900,0.55
2021-05-12,100,95,0.95,5,31,158,173,0.57
2021-05-13,144,131,0.91,13,26,147,157,0.64
2021-05-14,110,104,0.95,6,24,146,142,0.64
2021-05-15,126,111,0.88,15,31,158,276,0.53
2021-05-16,24,24,1.00,0,48,174,284,0.42
2021-05-17,128,122,0.95,6,35,179,162,0.52
2021-05-18,185,176,0.95,9,27,143,305,0.68
2021-05-19,136,114,0.84,22,57,145,331,0.29
2021-05-20,130,116,0.89,14,44,161,360,0.44
2021-05-21,103,101,0.98,2,18,162,143,0.77
2021-05-22,99,89,0.90,10,20,147,90,0.74
2021-05-23,26,24,0.92,2,23,120,113,0.68
2021-05-24,95,94,0.99,1,21,151,214,0.76
2021-05-25,136,131,0.96,5,17,149,141,0.81
2021-05-26,37,34,0.92,3,41,131,346,0.65
2021-05-27,105,100,0.95,5,22,150,132,0.72
2021-05-28,100,92,0.92,8,30,147,275,0.63
2021-05-29,115,103,0.90,12,44,166,275,0.37
2021-05-30,38,36,0.95,2,39,176,174,0.53
2021-05-31,108,95,0.88,13,26,169,166,0.64
2021-06-01,124,118,0.95,6,23,151,181,0.74
2021-06-02,97,92,0.95,5,25,156,143,0.68
2021-06-03,117,108,0.92,9,37,106,243,0.49
2021-06-04,34,31,0.91,3,27,157,152,0.65
2021-06-05,53,50,0.94,3,28,131,196,0.66
2021-06-06,29,23,0.79,6,42,167,220,0.32
2021-06-07,120,107,0.89,13,34,159,201,0.44
2021-06-08,107,100,0.93,7,33,153,128,0.51
2021-06-09,173,159,0.92,14,47,164,330,0.39
2021-06-10,256,213,0.83,43,44,165,318,0.42
2021-06-11,199,174,0.87,25,36,155,275,0.53
2021-06-12,182,170,0.93,12,40,164,207,0.46
2021-06-13,42,41,0.98,1,42,173,220,0.56
2021-06-14,181,168,0.93,13,34,155,163,0.52
2021-06-15,159,147,0.92,12,30,156,279,0.59
2021-06-16,142,134,0.94,8,26,170,110,0.62
2021-06-17,194,163,0.84,31,30,158,331,0.51
2021-06-18,235,210,0.89,25,38,173,275,0.49
2021-06-19,206,180,0.87,26,51,167,423,0.39
2021-06-20,58,47,0.81,11,48,156,275,0.42
2021-06-21,212,194,0.92,18,38,153,261,0.51
2021-06-22,232,214,0.92,18,34,156,330,0.56
2021-06-23,348,327,0.94,21,32,148,440,0.55
2021-06-24,167,156,0.93,11,32,163,177,0.57
2021-06-25,167,157,0.94,10,27,177,319,0.67
2021-06-26,166,161,0.97,5,21,165,92,0.73
2021-06-27,32,28,0.88,4,22,163,455,0.65
2021-06-28,52,49,0.94,3,32,178,182,0.63
2021-06-29,154,149,0.97,5,26,172,110,0.65
2021-06-30,223,218,0.98,5,18,127,120,0.80
2021-07-01,170,157,0.92,13,17,184,385,0.78
2021-07-02,145,133,0.92,12,26,176,219,0.69
2021-07-03,144,138,0.96,6,17,173,165,0.84
2021-07-04,16,15,0.94,1,17,180,165,0.69
2021-07-05,135,131,0.97,4,20,157,120,0.76
2021-07-06,137,133,0.97,4,24,169,166,0.69
2021-07-07,149,144,0.97,5,17,159,122,0.83
2021-07-08,155,143,0.92,12,16,161,385,0.80
2021-07-09,128,121,0.95,7,19,175,275,0.78
2021-07-10,134,125,0.93,9,21,158,198,0.73
2021-07-11,21,21,1.00,0,23,157,170,0.76
2021-07-12,150,138,0.92,12,30,172,256,0.59
2021-07-13,163,158,0.97,5,14,148,121,0.82
2021-07-14,160,151,0.94,9,12,159,177,0.87
2021-07-15,132,125,0.95,7,30,166,227,0.65
2021-07-16,131,126,0.96,5,17,167,155,0.78
2021-07-17,158,146,0.92,12,21,162,220,0.75
2021-07-18,19,16,0.84,3,51,166,254,0.47
2021-07-19,151,128,0.85,23,52,150,338,0.38
2021-07-20,139,128,0.92,11,32,164,214,0.52
2021-07-21,166,135,0.81,31,41,160,309,0.47
2021-07-22,258,196,0.76,62,70,150,471,0.24
2021-07-23,203,176,0.87,27,40,150,549,0.45
2021-07-24,182,162,0.89,20,25,168,220,0.59
2021-07-25,18,17,0.94,1,55,241,346,0.50
2021-07-26,215,170,0.79,45,55,169,446,0.43
2021-07-27,209,203,0.97,6,25,162,220,0.75
2021-07-28,140,134,0.96,6,20,179,201,0.76
2021-07-29,124,110,0.89,14,15,176,496,0.82
2021-07-30,179,163,0.91,16,23,164,257,0.72
2021-07-31,163,161,0.99,2,10,160,111,0.94
2021-08-01,27,27,1.00,0,5,168,19,1.00
2021-08-02,182,175,0.96,7,19,158,188,0.80
2021-08-03,164,159,0.97,5,11,143,388,0.90
2021-08-04,160,159,0.99,1,5,160,58,0.99
2021-08-05,174,155,0.89,19,16,161,399,0.77
2021-08-06,235,230,0.98,5,5,147,110,0.96
2021-08-07,175,174,0.99,1,4,146,113,0.99
2021-08-08,25,25,1.00,0,4,195,55,0.96
2021-08-09,170,167,0.98,3,6,155,220,0.94
2021-08-10,187,168,0.90,19,26,140,289,0.70
2021-08-11,53,51,0.96,2,6,149,110,0.89
2021-08-12,121,117,0.97,4,13,156,161,0.86
2021-08-13,143,139,0.97,4,5,146,116,0.94
2021-08-14,100,96,0.96,4,6,148,110,0.92
2021-08-15,17,17,1.00,0,8,175,59,0.88
2021-08-16,113,110,0.97,3,8,153,78,0.90
2021-08-17,139,128,0.92,11,13,158,220,0.82
2021-08-18,135,134,0.99,1,4,154,110,0.99
2021-08-19,29,29,1.00,0,15,193,89,0.79
2021-08-20,120,116,0.97,4,5,163,165,0.96
2021-08-21,115,108,0.94,7,9,170,265,0.89
2021-08-22,14,14,1.00,0,14,137,74,0.79
2021-08-23,107,104,0.97,3,7,149,58,0.91
2021-08-24,137,128,0.93,9,10,150,123,0.85
2021-08-25,106,105,0.99,1,11,167,113,0.86
2021-08-26,116,108,0.93,8,19,146,153,0.84
2021-08-27,120,117,0.98,3,9,157,65,0.91
2021-08-28,123,121,0.98,2,7,147,115,0.91
2021-08-29,31,31,1.00,0,3,138,3,1.00
2021-08-30,140,139,0.99,1,8,159,71,0.92
2021-08-31,168,161,0.96,7,18,144,144,0.74
2021-09-01,146,144,0.99,2,6,158,58,0.94
2021-09-02,110,106,0.96,4,15,170,150,0.80
2021-09-03,342,333,0.97,9,15,130,159,0.81
2021-09-04,190,183,0.96,7,16,152,119,0.79
2021-09-05,25,24,0.96,1,6,142,48,0.92
2021-09-06,169,162,0.96,7,9,151,276,0.89
2021-09-07,130,129,0.99,1,11,150,112,0.87
2021-09-08,22,20,0.91,2,9,195,110,0.90
2021-09-09,5,5,1.00,0,28,145,74,0.60
2021-09-10,119,115,0.97,4,11,148,110,0.86
2021-09-11,140,138,0.99,2,9,137,131,0.92
2021-09-12,22,22,1.00,0,6,141,48,0.91
2021-09-13,126,124,0.98,2,8,155,58,0.94
2021-09-14,122,111,0.91,11,13,163,133,0.78
2021-09-15,113,108,0.96,5,13,151,87,0.83
2021-09-16,119,109,0.92,10,17,156,315,0.84
2021-09-17,134,119,0.89,15,24,166,165,0.63
2021-09-18,101,97,0.96,4,16,153,98,0.77
2021-09-19,20,20,1.00,0,4,144,18,1.00
2021-09-20,169,162,0.96,7,17,152,331,0.80
2021-09-21,137,133,0.97,4,29,157,162,0.62
2021-09-22,133,127,0.95,6,18,159,276,0.82
2021-09-23,184,179,0.97,5,10,123,164,0.91
2021-09-24,145,135,0.93,10,21,155,190,0.74
2021-09-25,114,108,0.95,6,14,151,153,0.83
2021-09-26,24,23,0.96,1,5,132,55,0.96
2021-09-27,143,136,0.95,7,9,152,330,0.85
2021-09-28,119,114,0.96,5,8,142,79,0.91
2021-09-29,123,118,0.96,5,21,166,164,0.71
2021-09-30,145,141,0.97,4,14,156,110,0.83
2021-10-01,108,106,0.98,2,26,170,297,0.68
2021-10-02,128,125,0.98,3,13,165,102,0.83
2021-10-03,27,26,0.96,1,20,171,160,0.85
2021-10-04,155,151,0.97,4,11,152,138,0.90
2021-10-05,116,110,0.95,6,18,143,167,0.75
2021-10-06,117,111,0.95,6,18,163,126,0.77
2021-10-07,113,105,0.93,8,31,157,220,0.54
2021-10-08,107,101,0.94,6,23,164,191,0.74
2021-10-09,146,141,0.97,5,25,142,166,0.66
2021-10-10,29,26,0.90,3,9,157,110,0.86
2021-10-11,231,228,0.99,3,15,129,206,0.81
2021-10-12,239,215,0.90,24,23,156,275,0.67
2021-10-13,174,154,0.89,20,29,160,308,0.61
2021-10-14,168,163,0.97,5,21,169,165,0.71
2021-10-15,135,128,0.95,7,18,156,330,0.73
2021-10-16,122,113,0.93,9,30,169,220,0.61
2021-10-17,13,12,0.92,1,24,165,72,0.67
2021-10-18,20,18,0.90,2,23,163,164,0.74
2021-10-19,152,141,0.93,11,22,161,269,0.70
2021-10-20,132,131,0.99,1,12,159,120,0.87
2021-10-21,180,171,0.95,9,21,171,159,0.72
2021-10-22,193,189,0.98,4,13,155,146,0.83
2021-10-23,245,236,0.96,9,13,164,140,0.83
2021-10-24,35,34,0.97,1,11,131,104,0.88
2021-10-25,198,190,0.96,8,12,158,82,0.85
2021-10-26,47,47,1.00,0,6,129,57,0.94
2021-10-27,187,186,0.99,1,7,150,165,0.94
2021-10-28,57,54,0.95,3,7,157,55,0.91
2021-10-29,169,162,0.96,7,9,159,110,0.88
2021-10-30,337,316,0.94,21,23,133,317,0.73
2021-10-31,44,43,0.98,1,9,155,110,0.84
2021-11-01,210,206,0.98,4,12,159,152,0.87
2021-11-02,190,186,0.98,4,17,142,293,0.84
2021-11-03,190,182,0.96,8,10,160,98,0.87
2021-11-04,169,168,0.99,1,11,145,108,0.88
2021-11-05,52,50,0.96,2,6,154,58,0.92
2021-11-06,144,137,0.95,7,14,156,176,0.77
2021-11-07,36,36,1.00,0,15,173,101,0.81
2021-11-08,155,148,0.95,7,14,146,203,0.81
2021-11-09,159,154,0.97,5,16,161,132,0.79
2021-11-10,115,110,0.96,5,14,148,137,0.83
2021-11-11,186,173,0.93,13,19,159,164,0.74
2021-11-12,167,157,0.94,10,23,152,169,0.68
2021-11-13,146,142,0.97,4,22,162,119,0.67
2021-11-14,41,31,0.76,10,39,223,220,0.49
2021-11-15,185,85,0.46,100,109,166,661,0.04
2021-11-16,149,83,0.56,66,98,138,606,0.05
2021-11-17,180,115,0.64,65,64,153,770,0.24
2021-11-18,173,144,0.83,29,38,180,332,0.46
2021-11-19,176,158,0.90,18,20,153,315,0.70
2021-11-20,147,120,0.82,27,46,159,256,0.40
2021-11-21,84,77,0.92,7,17,127,270,0.73
2021-11-22,325,78,0.24,247,193,181,1047,0.00
2021-11-23,441,103,0.23,338,244,163,938,0.00
2021-11-24,525,116,0.22,409,308,188,1376,0.00
2021-11-25,610,201,0.33,409,193,172,1155,0.04
2021-11-26,427,282,0.66,145,62,169,882,0.25
2021-11-27,378,331,0.88,47,43,157,330,0.40
2021-11-28,80,67,0.84,13,38,192,330,0.46
2021-11-29,356,320,0.90,36,34,172,330,0.53
2021-11-30,409,355,0.87,54,44,175,261,0.40
2021-12-01,352,302,0.86,50,41,183,349,0.47
2021-12-02,282,239,0.85,43,39,186,506,0.51
2021-12-03,429,390,0.91,39,38,161,220,0.45
2021-12-04,310,285,0.92,25,33,165,252,0.56
2021-12-05,102,94,0.92,8,29,160,168,0.64
2021-12-06,335,297,0.89,38,39,153,222,0.44
2021-12-07,313,291,0.93,22,26,145,222,0.64
2021-12-08,251,240,0.96,11,24,162,165,0.67
2021-12-09,190,176,0.93,14,24,151,233,0.68
2021-12-10,188,170,0.90,18,34,169,385,0.53
2021-12-11,166,160,0.96,6,15,160,165,0.82
2021-12-12,73,68,0.93,5,15,133,148,0.79
2021-12-13,170,159,0.94,11,20,160,291,0.73
2021-12-14,188,181,0.96,7,23,159,181,0.68
2021-12-15,306,262,0.86,44,44,168,457,0.46
2021-12-16,201,185,0.92,16,23,158,166,0.67
2021-12-17,188,184,0.98,4,17,156,142,0.79
2021-12-18,148,131,0.89,17,31,171,216,0.53
2021-12-19,21,17,0.81,4,52,209,660,0.52
2021-12-20,148,129,0.87,19,40,181,416,0.46
2021-12-21,167,154,0.92,13,17,163,169,0.73
2021-12-22,169,158,0.93,11,16,156,104,0.75
2021-12-23,175,163,0.93,12,22,157,138,0.71
2021-12-24,193,183,0.95,10,16,169,168,0.80
2021-12-25,154,144,0.94,10,20,161,174,0.74
2021-12-26,35,34,0.97,1,14,186,58,0.77
2021-12-27,172,161,0.94,11,20,168,152,0.72
2021-12-28,195,182,0.93,13,24,171,190,0.67
2021-12-29,163,157,0.96,6,17,166,333,0.82
2021-12-30,134,126,0.94,8,30,178,299,0.64
2021-12-31,158,142,0.90,16,25,165,176,0.59
2022-01-01,161,144,0.89,17,34,169,300,0.53
2022-01-02,36,34,0.94,2,20,125,117,0.72
2022-01-03,147,136,0.93,11,17,175,195,0.77
2022-01-04,131,130,0.99,1,18,167,198,0.77
2022-01-05,128,120,0.94,8,22,167,114,0.68
2022-01-06,136,119,0.88,17,26,172,275,0.60
2022-01-07,225,209,0.93,16,19,149,246,0.76
2022-01-08,167,151,0.90,16,19,147,164,0.73
2022-01-09,48,46,0.96,2,16,146,158,0.79
2022-01-10,232,204,0.88,28,32,142,236,0.55
2022-01-11,198,187,0.94,11,27,168,193,0.60
2022-01-12,171,163,0.95,8,19,161,168,0.69
2022-01-13,180,173,0.96,7,31,169,493,0.72
2022-01-14,192,175,0.91,17,26,181,220,0.62
2022-01-15,194,180,0.93,14,25,170,243,0.68
2022-01-16,37,27,0.73,10,35,173,178,0.50
2022-01-17,180,169,0.94,11,23,164,125,0.68
2022-01-18,213,198,0.93,15,16,167,381,0.77
2022-01-19,251,239,0.95,12,21,138,168,0.72
2022-01-20,200,189,0.95,11,19,173,276,0.76
2022-01-21,214,205,0.96,9,25,168,437,0.72
2022-01-22,185,154,0.83,31,47,176,196,0.36
2022-01-23,49,46,0.94,3,38,141,136,0.52
2022-01-24,193,185,0.96,8,21,171,237,0.76
2022-01-25,195,184,0.94,11,22,159,158,0.70
2022-01-26,211,195,0.92,16,34,171,271,0.57
2022-01-27,200,190,0.95,10,15,176,186,0.81
2022-01-28,48,47,0.98,1,15,193,178,0.81
2022-01-29,164,159,0.97,5,20,171,287,0.78
2022-01-30,43,42,0.98,1,14,152,154,0.84
2022-01-31,236,223,0.94,13,26,166,218,0.65
2022-02-01,270,262,0.97,8,15,156,128,0.83
2022-02-02,304,262,0.86,42,34,176,421,0.57
2022-02-03,286,270,0.94,16,20,168,186,0.71
2022-02-04,317,284,0.90,33,30,168,496,0.66
2022-02-05,471,396,0.84,75,59,161,329,0.31
2022-02-06,48,44,0.92,4,29,151,187,0.66
2022-02-07,375,317,0.85,58,43,172,306,0.41
2022-02-08,327,309,0.95,18,22,168,226,0.68
2022-02-09,366,316,0.86,50,37,164,311,0.54
2022-02-10,121,105,0.87,16,47,180,521,0.60
2022-02-11,287,266,0.93,21,34,186,248,0.60
2022-02-12,298,277,0.93,21,39,188,215,0.51
2022-02-13,70,56,0.80,14,46,203,308,0.46
2022-02-14,287,255,0.89,32,40,210,249,0.47
2022-02-15,298,259,0.87,39,30,194,435,0.58
2022-02-16,347,317,0.91,30,30,191,352,0.60
2022-02-17,414,356,0.86,58,43,207,932,0.47
2022-02-18,406,362,0.89,44,37,182,317,0.53
2022-02-19,366,322,0.88,44,35,183,672,0.57
2022-02-20,68,64,0.94,4,14,178,124,0.82
2022-02-21,350,320,0.91,30,37,193,339,0.54
2022-02-22,437,352,0.81,85,52,181,573,0.41
2022-02-23,484,438,0.91,46,45,177,347,0.45
2022-02-24,405,368,0.91,37,35,189,341,0.58
2022-02-25,570,368,0.65,202,71,204,1551,0.24
2022-02-26,424,384,0.91,40,49,194,536,0.40
2022-02-27,60,57,0.95,3,32,199,180,0.56
2022-02-28,497,442,0.89,55,48,96,645,0.58
2022-03-01,429,378,0.88,51,37,125,655,0.55
2022-03-02,499,388,0.78,111,54,135,1019,0.48
2022-03-03,510,434,0.85,76,48,209,621,0.42
2022-03-04,549,458,0.83,91,73,215,552,0.29
2022-03-05,590,444,0.75,146,83,214,538,0.19
2022-03-06,137,120,0.88,17,58,191,322,0.33
2022-03-07,598,476,0.80,122,58,219,525,0.32
2022-03-08,231,180,0.78,51,64,213,547,0.34
2022-03-09,724,362,0.50,362,121,235,738,0.12
2022-03-10,732,367,0.50,365,168,172,998,0.08
2022-03-11,582,301,0.52,281,161,253,1302,0.12
2022-03-12,621,344,0.55,277,127,209,744,0.14
2022-03-13,116,106,0.91,10,34,263,284,0.63
2022-03-14,533,300,0.56,233,132,243,744,0.13
2022-03-15,416,322,0.77,94,64,214,372,0.39
2022-03-16,415,259,0.62,156,130,237,818,0.18
2022-03-17,433,289,0.67,144,102,208,792,0.23
2022-03-18,454,284,0.63,170,113,214,1162,0.24
2022-03-19,244,195,0.80,49,85,231,682,0.37
2022-03-20,51,48,0.94,3,14,206,201,0.84
2022-03-21,202,176,0.87,26,24,222,328,0.67
2022-03-22,128,118,0.92,10,30,222,473,0.74
2022-03-23,102,100,0.98,2,14,212,189,0.85
2022-03-24,201,169,0.84,32,32,205,372,0.58
2022-03-25,261,195,0.75,66,61,207,475,0.38
2022-03-26,201,173,0.86,28,41,195,410,0.60
2022-03-27,64,61,0.95,3,9,195,143,0.92
2022-03-28,200,168,0.84,32,51,203,406,0.49
2022-03-29,158,148,0.94,10,30,197,248,0.57
2022-03-30,174,155,0.89,19,26,181,310,0.62
2022-03-31,67,64,0.96,3,26,211,298,0.71
2022-04-01,24,23,0.96,1,23,170,121,0.75
2022-04-02,106,92,0.87,14,44,183,304,0.46
2022-04-03,52,50,0.96,2,11,199,84,0.88
2022-04-04,223,203,0.91,20,31,198,251,0.62
2022-04-05,274,233,0.85,41,48,207,310,0.36
2022-04-06,280,263,0.94,17,23,193,230,0.68
2022-04-07,534,468,0.88,66,30,166,279,0.57
2022-04-08,315,300,0.95,15,24,191,170,0.70
2022-04-09,122,113,0.93,9,20,178,139,0.77
2022-04-10,63,60,0.95,3,21,171,172,0.74
2022-04-11,402,368,0.92,34,32,187,186,0.54
2022-04-12,413,370,0.90,43,29,190,202,0.58
2022-04-13,389,346,0.89,43,36,201,310,0.50
2022-04-14,495,308,0.62,187,91,205,995,0.19
2022-04-15,712,340,0.48,372,120,206,985,0.12
2022-04-16,1057,602,0.57,455,104,153,744,0.11
2022-04-17,620,321,0.52,299,162,193,994,0.11
2022-04-18,1575,871,0.55,704,92,153,1365,0.14
2022-04-19,1349,775,0.57,574,106,190,953,0.12
2022-04-20,999,454,0.45,545,168,194,804,0.04
2022-04-21,968,547,0.57,421,146,198,853,0.12
2022-04-22,1066,453,0.43,613,304,219,1357,0.02
2022-04-23,788,633,0.80,155,73,203,746,0.21
2022-04-24,252,213,0.85,39,53,211,497,0.44
2022-04-25,842,625,0.74,217,71,190,868,0.27
2022-04-26,847,722,0.85,125,54,184,485,0.33
2022-04-27,800,615,0.77,185,67,205,444,0.24
2022-04-28,1100,823,0.75,277,68,198,931,0.30
2022-04-29,1242,909,0.73,333,83,184,671,0.19
2022-04-30,732,460,0.63,272,91,192,629,0.18
2022-05-01,112,104,0.93,8,34,201,253,0.56
2022-05-02,482,434,0.90,48,41,181,661,0.47
2022-05-03,570,484,0.85,86,51,187,708,0.37
2022-05-04,490,398,0.81,92,50,197,1304,0.36
2022-05-05,462,311,0.67,151,71,197,530,0.26
2022-05-06,428,373,0.87,55,40,178,421,0.51
2022-05-07,393,312,0.79,81,62,196,496,0.31
2022-05-08,58,50,0.86,8,29,184,186,0.67
2022-05-09,316,279,0.88,37,40,178,211,0.44
2022-05-10,298,274,0.92,24,30,179,182,0.56
2022-05-11,308,275,0.89,33,40,176,414,0.52
2022-05-12,259,242,0.93,17,16,174,249,0.78
2022-05-13,464,391,0.84,73,55,211,313,0.35
2022-05-14,302,275,0.91,27,30,182,594,0.56
2022-05-15,47,45,0.96,2,12,161,157,0.85
2022-05-16,293,279,0.95,14,22,173,177,0.67
2022-05-17,245,225,0.92,20,18,175,251,0.74
2022-05-18,295,227,0.77,68,48,199,342,0.45
2022-05-19,205,196,0.96,9,20,186,310,0.74
2022-05-20,249,215,0.86,34,40,178,1491,0.46
2022-05-21,236,213,0.90,23,26,194,234,0.63
2022-05-22,39,39,1.00,0,14,150,147,0.87
2022-05-23,208,194,0.93,14,17,174,179,0.77
2022-05-24,39,38,0.97,1,4,141,62,0.95
2022-05-25,115,110,0.96,5,8,166,252,0.90
2022-05-26,338,308,0.91,30,27,170,251,0.63
2022-05-27,404,320,0.79,84,45,178,713,0.51
2022-05-28,436,393,0.90,43,26,171,373,0.65
2022-05-29,73,72,0.99,1,7,166,103,0.93
2022-05-30,521,492,0.94,29,17,165,203,0.79
2022-05-31,648,564,0.87,84,27,166,325,0.61
2022-06-01,729,592,0.81,137,55,173,449,0.36
2022-06-02,1196,718,0.60,478,112,189,666,0.15
2022-06-03,436,323,0.74,113,44,182,372,0.44
2022-06-04,191,178,0.93,13,16,171,248,0.81
2022-06-05,68,68,1.00,0,5,176,99,0.99
2022-06-06,498,429,0.86,69,34,189,252,0.51
2022-06-07,358,329,0.92,29,21,183,135,0.67
2022-06-08,340,302,0.89,38,24,170,310,0.66
2022-06-09,322,306,0.95,16,16,159,377,0.78
2022-06-10,296,282,0.95,14,18,157,165,0.77
2022-06-11,264,234,0.89,30,20,154,294,0.70
2022-06-12,52,51,0.98,1,6,156,65,0.94
2022-06-13,266,264,0.99,2,9,159,121,0.91
2022-06-14,242,238,0.98,4,9,165,150,0.90
2022-06-15,241,228,0.95,13,19,168,368,0.80
2022-06-16,279,269,0.96,10,8,163,187,0.91
2022-06-17,73,72,0.99,1,8,184,130,0.92
2022-06-18,226,218,0.96,8,8,174,167,0.92
2022-06-19,43,42,0.98,1,11,158,77,0.84
2022-06-20,311,255,0.82,56,45,175,290,0.47
2022-06-21,251,210,0.84,41,26,174,558,0.64
2022-06-22,339,313,0.92,26,12,122,401,0.82
2022-06-23,323,261,0.81,62,41,177,567,0.54
2022-06-24,289,265,0.92,24,11,180,342,0.83
2022-06-25,310,281,0.91,29,15,161,177,0.79
2022-06-26,33,31,0.94,2,14,173,127,0.85
2022-06-27,346,318,0.92,28,12,156,212,0.82
2022-06-28,325,285,0.88,40,32,165,579,0.61
2022-06-29,627,504,0.80,123,37,200,1182,0.57
2022-06-30,905,631,0.70,274,83,222,724,0.26
2022-07-01,1141,610,0.53,531,106,192,1551,0.15
2022-07-02,863,511,0.59,352,127,183,943,0.12
2022-07-03,63,56,0.89,7,16,151,248,0.71
2022-07-04,573,487,0.85,86,56,165,343,0.35
2022-07-05,391,323,0.83,68,46,188,496,0.43
2022-07-06,526,355,0.67,171,89,230,1127,0.22
2022-07-07,343,309,0.90,34,39,204,310,0.49
2022-07-08,401,346,0.86,55,41,193,310,0.44
2022-07-09,281,239,0.85,42,41,187,200,0.43
2022-07-10,46,39,0.85,7,11,189,249,0.80
2022-07-11,357,323,0.90,34,32,188,434,0.61
2022-07-12,280,255,0.91,25,34,182,211,0.53
2022-07-13,258,247,0.96,11,25,177,252,0.70
2022-07-14,282,255,0.90,27,18,167,249,0.75
2022-07-15,253,240,0.95,13,18,161,371,0.75
2022-07-16,266,232,0.87,34,37,169,371,0.58
2022-07-17,30,29,0.97,1,10,201,49,0.90
2022-07-18,258,230,0.89,28,33,181,254,0.54
2022-07-19,293,282,0.96,11,23,159,158,0.70
2022-07-20,377,341,0.90,36,20,141,189,0.68
2022-07-21,196,182,0.93,14,28,157,174,0.62
2022-07-22,192,173,0.90,19,33,164,399,0.62
2022-07-23,185,178,0.96,7,17,166,189,0.78
2022-07-24,27,25,0.93,2,18,129,187,0.74
2022-07-25,222,214,0.96,8,18,177,372,0.75
2022-07-26,217,198,0.91,19,9,163,177,0.89
2022-07-27,204,197,0.97,7,17,160,230,0.80
2022-07-28,191,181,0.95,10,12,166,284,0.87
2022-07-29,176,157,0.89,19,17,171,248,0.74
2022-07-30,176,163,0.93,13,24,191,187,0.64
2022-07-31,26,26,1.00,0,24,183,117,0.69
2022-08-01,170,167,0.98,3,16,167,128,0.79
2022-08-02,154,147,0.95,7,21,182,227,0.75
2022-08-03,165,152,0.92,13,17,178,220,0.81
2022-08-04,153,143,0.93,10,19,185,195,0.78
2022-08-05,175,169,0.97,6,11,137,132,0.86
2022-08-06,241,214,0.89,27,29,180,873,0.66
2022-08-07,14,14,1.00,0,16,166,87,0.86
2022-08-08,57,55,0.96,2,12,155,127,0.86
2022-08-09,954,644,0.68,310,74,125,672,0.26
2022-08-10,374,344,0.92,30,28,183,532,0.62
2022-08-11,265,245,0.92,20,31,185,201,0.57
2022-08-12,222,205,0.92,17,20,192,130,0.73
2022-08-13,203,192,0.95,11,27,184,247,0.69
2022-08-14,33,31,0.94,2,29,135,343,0.78
2022-08-15,220,195,0.89,25,28,165,186,0.60
2022-08-16,185,177,0.96,8,16,153,188,0.80
2022-08-17,203,172,0.85,31,34,173,306,0.53
2022-08-18,218,193,0.89,25,34,178,454,0.62
2022-08-19,204,194,0.95,10,16,172,186,0.81
2022-08-20,242,211,0.87,31,44,177,368,0.48
2022-08-21,29,29,1.00,0,8,160,44,0.90
2022-08-22,171,163,0.95,8,24,178,199,0.69
2022-08-23,190,166,0.87,24,46,179,560,0.42
2022-08-24,221,196,0.89,25,33,177,325,0.54
2022-08-25,297,241,0.81,56,49,191,412,0.45
2022-08-26,233,214,0.92,19,26,169,233,0.63
2022-08-27,198,191,0.96,7,14,181,129,0.83
2022-08-28,15,15,1.00,0,4,199,14,1.00
2022-08-29,27,25,0.93,2,8,154,124,0.89
2022-08-30,7,6,0.86,1,3,288,31,0.86
2022-08-31,169,144,0.85,25,33,156,511,0.56
2022-09-01,224,206,0.92,18,20,155,146,0.71
2022-09-02,170,160,0.94,10,28,181,310,0.62
2022-09-03,161,149,0.93,12,24,188,154,0.68
2022-09-04,37,35,0.95,2,12,168,63,0.81
2022-09-05,183,169,0.92,14,32,178,268,0.60
2022-09-06,221,206,0.93,15,30,174,263,0.58
2022-09-07,202,193,0.96,9,18,173,168,0.75
2022-09-08,193,163,0.84,30,36,192,312,0.53
2022-09-09,201,196,0.98,5,10,163,152,0.89
2022-09-10,193,180,0.93,13,21,162,197,0.73
2022-09-11,27,25,0.93,2,25,123,127,0.67
2022-09-12,227,206,0.91,21,29,181,266,0.67
2022-09-13,225,199,0.88,26,35,178,319,0.53
2022-09-14,204,193,0.95,11,33,159,321,0.59
2022-09-15,221,194,0.88,27,29,168,305,0.61
2022-09-16,172,154,0.90,18,34,189,186,0.54
2022-09-17,161,150,0.93,11,36,171,353,0.53
2022-09-18,17,14,0.82,3,47,188,172,0.41
2022-09-19,168,145,0.86,23,38,177,248,0.51
2022-09-20,160,142,0.89,18,33,164,558,0.54
2022-09-21,185,159,0.86,26,41,176,343,0.43
2022-09-22,155,146,0.94,9,28,169,207,0.65
2022-09-23,188,172,0.91,16,28,159,184,0.60
2022-09-24,152,120,0.79,32,29,174,395,0.53
2022-09-25,26,26,1.00,0,17,181,78,0.81
2022-09-26,152,140,0.92,12,21,178,400,0.71
2022-09-27,130,125,0.96,5,8,159,62,0.92
2022-09-28,191,187,0.98,4,18,153,173,0.83
2022-09-29,254,227,0.89,27,33,177,275,0.57
2022-09-30,213,188,0.88,25,30,172,310,0.55
2022-10-01,176,151,0.86,25,32,165,372,0.56
2022-10-02,61,59,0.97,2,16,91,186,0.80
2022-10-03,166,154,0.93,12,28,176,196,0.62
2022-10-04,191,172,0.90,19,21,160,203,0.74
2022-10-05,171,157,0.92,14,19,154,127,0.73
2022-10-06,153,124,0.81,29,50,184,361,0.45
2022-10-07,183,158,0.86,25,33,172,310,0.52
2022-10-08,14,14,1.00,0,15,223,92,0.86
2022-10-09,18,18,1.00,0,3,176,6,1.00
2022-10-10,159,148,0.93,11,22,156,195,0.69
2022-10-11,143,134,0.94,9,22,171,310,0.74
2022-10-12,195,175,0.90,20,29,167,251,0.62
2022-10-13,194,150,0.77,44,37,167,257,0.47
2022-10-14,390,362,0.93,28,31,170,346,0.59
2022-10-15,238,205,0.86,33,29,138,310,0.61
2022-10-16,29,28,0.97,1,9,148,65,0.89
2022-10-17,30,29,0.97,1,19,150,151,0.83
2022-10-18,287,273,0.95,14,16,140,186,0.79
2022-10-19,474,380,0.80,94,39,128,478,0.47
2022-10-20,277,230,0.83,47,40,172,373,0.46
2022-10-21,173,163,0.94,10,17,166,164,0.77
2022-10-22,167,152,0.91,15,13,157,310,0.84
2022-10-23,27,24,0.89,3,20,125,223,0.77
2022-10-24,173,153,0.88,20,29,166,186,0.58
2022-10-25,36,27,0.75,9,36,175,237,0.42
2022-10-26,186,171,0.92,15,27,169,208,0.64
2022-10-27,160,149,0.93,11,23,167,292,0.74
2022-10-28,233,215,0.92,18,22,154,488,0.74
2022-10-29,162,157,0.97,5,13,152,310,0.83
2022-10-30,27,24,0.89,3,18,130,231,0.70
2022-10-31,168,155,0.92,13,26,198,188,0.65
2022-11-01,328,301,0.92,27,23,149,419,0.68
2022-11-02,234,208,0.89,26,20,164,318,0.72
2022-11-03,37,34,0.92,3,14,136,224,0.84
2022-11-04,185,167,0.90,18,18,163,372,0.74
2022-11-05,139,132,0.95,7,10,177,208,0.88
2022-11-06,13,11,0.85,2,46,127,155,0.42
2022-11-07,161,152,0.94,9,23,148,172,0.70
2022-11-08,149,144,0.97,5,15,166,181,0.83
2022-11-09,178,167,0.94,11,22,162,324,0.75
2022-11-10,224,210,0.94,14,21,180,287,0.73
2022-11-11,277,273,0.99,4,10,120,123,0.90
2022-11-12,188,172,0.91,16,20,161,216,0.72
2022-11-13,26,22,0.85,4,34,143,378,0.68
2022-11-14,177,167,0.94,10,35,176,195,0.56
2022-11-15,149,144,0.97,5,28,167,228,0.66
2022-11-16,147,147,1.00,0,11,171,123,0.86
2022-11-17,140,134,0.96,6,19,164,499,0.79
2022-11-18,177,163,0.92,14,19,155,436,0.76
2022-11-19,169,169,1.00,0,9,165,65,0.90
2022-11-20,26,21,0.81,5,27,148,124,0.48
2022-11-21,147,140,0.95,7,12,168,131,0.86
2022-11-22,127,122,0.96,5,21,168,127,0.71
2022-11-23,141,135,0.96,6,17,147,248,0.78
2022-11-24,208,181,0.87,27,38,159,248,0.49
2022-11-25,178,163,0.92,15,33,174,298,0.55
2022-11-26,198,190,0.96,8,25,152,142,0.67
2022-11-27,21,17,0.81,4,44,211,277,0.48
2022-11-28,171,161,0.94,10,16,155,374,0.81
2022-11-29,200,196,0.98,4,9,171,121,0.92
2022-11-30,166,157,0.95,9,24,160,114,0.65
2022-12-01,230,217,0.94,13,27,159,123,0.57
2022-12-02,174,168,0.97,6,24,177,174,0.70
2022-12-03,240,185,0.77,55,60,182,300,0.30
2022-12-04,35,27,0.77,8,48,176,233,0.43
2022-12-05,198,179,0.90,19,27,161,580,0.60
2022-12-06,189,181,0.96,8,19,179,164,0.71
2022-12-07,229,219,0.96,10,30,195,385,0.59
2022-12-08,254,235,0.93,19,27,176,232,0.60
2022-12-09,584,521,0.89,63,29,136,261,0.58
2022-12-10,564,551,0.98,13,12,100,106,0.84
2022-12-11,150,149,0.99,1,10,100,131,0.89
2022-12-12,521,499,0.96,22,23,96,184,0.71
2022-12-13,330,309,0.94,21,21,199,392,0.70
2022-12-14,298,288,0.97,10,13,200,243,0.85
2022-12-15,294,287,0.98,7,14,208,199,0.82
2022-12-16,261,253,0.97,8,10,183,348,0.90
2022-12-17,223,210,0.94,13,16,187,323,0.80
2022-12-18,59,58,0.98,1,21,221,192,0.75
2022-12-19,340,327,0.96,13,21,115,226,0.78
2022-12-20,287,280,0.98,7,13,185,116,0.84
2022-12-21,269,257,0.96,12,16,184,229,0.82
2022-12-22,270,261,0.97,9,12,186,269,0.86
2022-12-23,285,273,0.96,12,12,194,173,0.85
2022-12-24,251,229,0.91,22,22,179,186,0.73
2022-12-25,47,47,1.00,0,13,183,89,0.87
2022-12-26,233,225,0.97,8,13,182,117,0.85
2022-12-27,257,248,0.97,9,14,194,222,0.83
2022-12-28,245,234,0.96,11,11,181,116,0.86
2022-12-29,267,265,0.99,2,5,179,73,0.97
2022-12-30,231,224,0.97,7,11,176,174,0.87
2022-12-31,236,226,0.96,10,19,184,186,0.75
2023-01-01,81,78,0.96,3,11,177,58,0.81
2023-01-02,281,273,0.97,8,11,182,201,0.88
2023-01-03,399,387,0.97,12,11,171,145,0.86
2023-01-04,291,287,0.99,4,11,156,218,0.88
2023-01-05,290,281,0.97,9,7,183,60,0.92
2023-01-06,230,227,0.99,3,8,186,72,0.92
2023-01-07,236,216,0.92,20,17,189,174,0.71
2023-01-08,45,44,0.98,1,5,165,116,0.93
2023-01-09,249,238,0.96,11,11,162,118,0.87
2023-01-10,350,328,0.94,22,28,151,148,0.58
2023-01-11,361,306,0.85,55,27,146,401,0.60
2023-01-12,262,256,0.98,6,13,170,174,0.86
2023-01-13,302,288,0.95,14,21,176,179,0.71
2023-01-14,299,268,0.90,31,28,169,178,0.55
2023-01-15,50,49,0.98,1,24,175,128,0.76
2023-01-16,285,273,0.96,12,21,169,210,0.76
2023-01-17,77,75,0.97,2,9,163,130,0.92
2023-01-18,332,321,0.97,11,17,178,214,0.81
2023-01-19,282,266,0.94,16,22,190,492,0.74
2023-01-20,256,248,0.97,8,14,180,232,0.82
2023-01-21,177,176,0.99,1,12,157,105,0.84
2023-01-22,27,24,0.89,3,13,135,68,0.74
2023-01-23,307,305,0.99,2,9,181,102,0.92
2023-01-24,587,577,0.98,10,10,128,116,0.92
2023-01-25,270,265,0.98,5,7,164,116,0.92
2023-01-26,307,297,0.97,10,14,179,175,0.82
2023-01-27,242,238,0.98,4,6,162,115,0.95
2023-01-28,194,182,0.94,12,12,177,96,0.81
2023-01-29,21,21,1.00,0,12,187,94,0.90
2023-01-30,291,288,0.99,3,7,166,84,0.94
2023-01-31,516,479,0.93,37,26,160,211,0.64
2023-02-01,452,447,0.99,5,6,124,232,0.94
2023-02-02,375,375,1.00,0,5,133,65,0.97
2023-02-03,306,287,0.94,19,19,135,290,0.76
2023-02-04,241,235,0.98,6,15,160,117,0.80
2023-02-05,34,34,1.00,0,18,181,128,0.85
2023-02-06,248,238,0.96,10,19,163,273,0.74
2023-02-07,323,307,0.95,16,13,162,208,0.83
2023-02-08,260,257,0.99,3,10,149,102,0.91
2023-02-09,316,311,0.98,5,10,161,174,0.88
2023-02-10,60,59,0.98,1,3,161,115,0.98
2023-02-11,267,251,0.94,16,19,147,464,0.76
2023-02-12,30,29,0.97,1,8,120,46,0.93
2023-02-13,247,238,0.96,9,13,155,174,0.83
2023-02-14,376,365,0.97,11,15,180,210,0.82
2023-02-15,316,306,0.97,10,13,175,118,0.83
2023-02-16,310,304,0.98,6,7,171,100,0.92
2023-02-17,340,327,0.96,13,23,175,154,0.71
2023-02-18,306,289,0.94,17,24,163,304,0.70
2023-02-19,40,40,1.00,0,5,166,51,0.98
2023-02-20,378,370,0.98,8,11,172,156,0.87
2023-02-21,424,416,0.98,8,14,174,221,0.84
2023-02-22,356,353,0.99,3,5,168,64,0.97
2023-02-23,320,308,0.96,12,10,153,204,0.89
2023-02-24,351,341,0.97,10,11,170,109,0.86
2023-02-25,85,83,0.98,2,13,167,224,0.86
2023-02-26,44,43,0.98,1,9,153,232,0.84
2023-02-27,388,363,0.94,25,19,186,174,0.75
2023-02-28,283,280,0.99,3,6,185,109,0.96
2023-03-01,241,238,0.99,3,5,175,196,0.97
2023-03-02,280,273,0.98,7,9,166,218,0.88
2023-03-03,294,273,0.93,21,26,196,164,0.62
2023-03-04,290,246,0.85,44,27,184,284,0.64
2023-03-05,32,32,1.00,0,6,163,70,0.97
2023-03-06,270,263,0.97,7,12,172,120,0.85
2023-03-07,212,208,0.98,4,8,163,154,0.91
2023-03-08,246,238,0.97,8,7,173,228,0.92
2023-03-09,194,190,0.98,4,8,163,214,0.93
2023-03-10,179,176,0.98,3,6,164,103,0.96
2023-03-11,67,65,0.97,2,9,156,119,0.90
2023-03-12,27,27,1.00,0,9,147,93,0.89
2023-03-13,190,183,0.96,7,9,158,174,0.88
2023-03-14,213,205,0.96,8,10,158,302,0.88
2023-03-15,208,205,0.99,3,4,156,173,0.97
2023-03-16,166,165,0.99,1,8,161,211,0.93
2023-03-17,169,161,0.95,8,18,172,217,0.74
2023-03-18,175,167,0.95,8,10,149,232,0.86
2023-03-19,43,43,1.00,0,4,162,29,1.00
2023-03-20,24,24,1.00,0,3,166,3,1.00
2023-03-21,26,26,1.00,0,5,172,58,0.92
2023-03-22,42,41,0.98,1,3,161,3,1.00
2023-03-23,37,36,0.97,1,5,144,290,0.95
2023-03-24,60,60,1.00,0,5,187,61,0.97
2023-03-25,82,81,0.99,1,3,144,58,0.98
2023-03-26,31,31,1.00,0,6,140,61,0.94
2023-03-27,178,171,0.96,7,16,163,126,0.76
2023-03-28,183,175,0.96,8,13,147,278,0.86
2023-03-29,39,37,0.95,2,3,173,58,0.97
2023-03-30,170,167,0.98,3,12,144,170,0.85
2023-03-31,180,168,0.93,12,12,166,269,0.83
2023-04-01,24,24,1.00,0,4,156,21,1.00
2023-04-02,7,7,1.00,0,33,159,93,0.43
2023-04-03,181,181,1.00,0,12,167,89,0.88
2023-04-04,209,206,0.99,3,5,162,58,0.95
2023-04-05,180,179,0.99,1,4,148,62,0.97
2023-04-06,221,203,0.92,18,12,163,175,0.87
2023-04-07,254,248,0.98,6,10,168,187,0.91
2023-04-08,627,577,0.92,50,41,159,320,0.48
2023-04-09,167,159,0.95,8,18,190,235,0.76
2023-04-10,599,554,0.92,45,25,155,290,0.64
2023-04-11,304,300,0.99,4,7,155,175,0.92
2023-04-12,267,260,0.97,7,8,176,114,0.91
2023-04-13,286,281,0.98,5,11,160,174,0.87
2023-04-14,196,192,0.98,4,13,163,126,0.86
2023-04-15,191,189,0.99,2,11,180,154,0.88
2023-04-16,60,60,1.00,0,6,118,59,0.97
2023-04-17,215,207,0.96,8,10,160,104,0.90
2023-04-18,221,213,0.96,8,8,155,107,0.90
2023-04-19,201,193,0.96,8,3,166,58,0.98
2023-04-20,205,202,0.99,3,5,168,69,0.96
2023-04-21,201,194,0.97,7,14,164,149,0.84
2023-04-22,140,132,0.94,8,7,111,116,0.92
2023-04-23,29,28,0.97,1,13,189,107,0.83
2023-04-24,398,372,0.93,26,21,171,253,0.73
2023-04-25,255,249,0.98,6,15,181,129,0.83
2023-04-26,283,278,0.98,5,17,158,119,0.80
2023-04-27,230,222,0.97,8,21,166,165,0.72
2023-04-28,185,183,0.99,2,10,195,80,0.90
2023-04-29,197,194,0.98,3,13,169,121,0.83
2023-04-30,15,14,0.93,1,12,194,108,0.87
2023-05-01,230,228,0.99,2,7,167,61,0.94
2023-05-02,232,224,0.97,8,12,171,94,0.86
2023-05-03,237,231,0.97,6,11,181,119,0.88
2023-05-04,42,39,0.93,3,17,171,100,0.79
2023-05-05,215,211,0.98,4,6,186,174,0.95
2023-05-06,153,152,0.99,1,4,155,55,0.99
2023-05-07,39,39,1.00,0,14,222,97,0.85
2023-05-08,334,322,0.96,12,17,176,138,0.77
2023-05-09,236,225,0.95,11,13,173,116,0.85
2023-05-10,186,182,0.98,4,8,158,130,0.95
2023-05-11,202,197,0.98,5,13,153,116,0.87
2023-05-12,185,182,0.98,3,8,169,153,0.90
2023-05-13,38,38,1.00,0,4,206,57,0.97
2023-05-14,25,24,0.96,1,3,164,46,0.96
2023-05-15,203,195,0.96,8,8,158,514,0.89
2023-05-16,296,292,0.99,4,4,160,58,0.99
2023-05-17,233,223,0.96,10,9,167,106,0.88
2023-05-18,198,194,0.98,4,8,162,103,0.92
2023-05-19,181,179,0.99,2,4,159,48,0.99
2023-05-20,166,162,0.98,4,6,159,61,0.94
2023-05-21,19,19,1.00,0,3,147,3,1.00
2023-05-22,196,181,0.92,15,14,157,156,0.78
2023-05-23,176,172,0.98,4,16,150,176,0.79
2023-05-24,221,209,0.95,12,12,162,170,0.84
2023-05-25,196,191,0.97,5,14,171,354,0.86
2023-05-26,211,202,0.96,9,15,166,174,0.79
2023-05-27,201,194,0.97,7,16,169,208,0.81
2023-05-28,23,22,0.96,1,10,182,62,0.83
2023-05-29,225,210,0.93,15,10,157,217,0.86
2023-05-30,202,195,0.97,7,11,167,112,0.87
2023-05-31,191,184,0.96,7,7,170,116,0.93
2023-06-01,212,209,0.99,3,10,171,105,0.89
2023-06-02,210,203,0.97,7,12,202,232,0.85
2023-06-03,167,159,0.95,8,16,196,162,0.83
2023-06-04,12,11,0.92,1,3,132,58,0.92